afford -- позволить -- provide -- ban, forbid
convenient -- удобный -- comfortable -- inconvinient, uncomfortable
shone -- светиться -- dlow, radiate -- not to shone
thickness -- толщина
along -- вдоль 
make sence -- иметь смысл
rubbish -- чушь, вздор, хлам, мусор -- garbage, trash -- true
odd -- странный -- strange, weird -- normal
shining -- блестящий -- glowing, radiating -- unglowing
stare -- выпучить глаза -- to be surprised -- look
felt -- почувствовал 
host -- хозяин -- master, owner
pity -- печальный факт, сострадание
attend -- посещать
dull -- скучный, тупой -- stupid
at last -- наконец
grayer -- седее
chin -- подбородок
limp -- прихрамывание
fil -- наполнить
dried -- высушенный
behavior -- поведение
plate -- плита
stomach -- желудок
give a pound a line -- отдам фунт за каждую строчку / готов заплатить за каждое слово
poured -- налитый, вылитый, пролитый, разлитый, выпивали
look round -- посмотрел вокруг
led the way -- провёл 
mind -- возражать, иметь в виду
interrupt -- прерывать
shan't = shall not -- не должен
the speaker's white -?- седина -- gray
